%%%%%%%%
%P     %
% .% . %
%  %   %
% .% . %
%    .G%
%%%%%%%%
